XXXXXXXXXXXXXXXXXXXXXXXXXXX
XQQQQQQQXXXXXXXXXXXXXQGXQOX
XQMQQQTQQQQQQQQQQQQQQQQXQQX
XXXXXXX XXXXXXXXXXXXXQXXXQX
XQQGQQXQTQTQQQTQQQTQTQQQQQX
XQXXXQXQX Q XQO XQQ X QXXQX
XQXOXQXQXXXXXXXXXXXXXQQQQQX
XQXQXQXQQQGQQQQQQQQQQQQXXQX
XQXQXTXQXXXXXXQXXXXXQXXXXQX
XQQQQQ QXQOQQQQXXXXXQQQQQGX
XXXXXXXXXXXXXXXXXXXXXXXXXXX