XXXXXXXXXXXXXXXXXXXXXXXXXXX
XMQQXXXXQQQQQQQQQQQXXXXQQQX
XQXQOQTQQXXXXXXXXXQQTQOQXQX
XQXXXXX XXXQQQQQXXXXX XXXQX
XQQQGQQQQQTQXQXQTQQQQQGQQQX
XXXXXXXTXXX XXXQX XXXXXXXXX
XQQGQQQQ QTQXQXQTQQQQQQGQQX
XQXXXXXQXQX QQQQX XQXXXXXQX
XQOQQQXQXQXXXXXXXQXQQQQQOQX
XXQXXQXQQQQQQQQQQQXQXQXXQXX
XXXXXXXXXXXXXXXXXXXXXXXXXXX