XXXXXXXXXXXXXXXXXXXXXXXXXXX
XGQQTQQQQQQQQOQQQQQQQQTQQGX
XXXQX XQQXXXXXXXXXQQXQX XXX
XQQQQQXQQTQQQXQQQTQQXQQQQQX
XQXXXXXQQX QQMQQQX QXXXXXQX
XQQXQQQQQXQQQXQQQTQQQQQTQQX
XXXXXXXXQXXXXXXXXX XXXXX XX
XOQQQQGTQQQQQOQQQQQQXGQQQOX
XQXXXXXX XXXXXXXXXXQXXXXXQX
XQQQQQQQQQQQQXQQQQQQQQQQQQX
XXXXXXXXXXXXXXXXXXXXXXXXXXX